11111111111111111111111
100000000000000000001E1
1000P000000000000000111
10000000000000000000001
11111111111111111111111