11111111111111111111111
100000000E0000000000001
1000P000000000000000000
100000000C0000000000001
11111111111111111111111