11111111111111111111111
1000000C0000000000000E1
1000P000000000000000111
100000000000000000001C1
11111111111111111111111