1111111111111111111111111111111111
1E0000000000000C00G00C000000000001
1010010100100G0010100100G000010101
1010010010101P10001001000000010111
100000000CG0C0000000000000000000C1
100000000CG0C0000000000000000000C1
100000000CG0C0000000000000000000C1
100000000CG0C0000000000000000000C1
1111111111111111111111111111111111