1111
1P01
1001
1001
1GG1
1001
1001
10E1
1001
10G1
1001
1C01
1111