111111111111111111111111111111111
1E00000000000000000000000000G00C1
111111111111111111111111111000P01
111111111111111111111111111111111