111111111111111111111111111111111
1E00000000000000000G00P00000000C1
100000000000000000000000000000001
111111111111111111111111111111111