11111111111111111111111
10000000000000000000001
1000P000000000000000001
1000000000000E000000001
11111111111111111111111