11111111111111
1C0000000000C1
10111111111101
10100000000101
10101111110101
10101000010101
1010101E010101
10101011110101
10101000000101
10101111111101
1P100000000001
11111111111111