1111111111111111111111111111111111111111111111111111
1000000000000000000000001010000000000000000000000001
1000000000000000000000001010000000000000000000000001
1000000000000000000000010001000000000000000000000001
1000000000000000000000100000100000000000000000000001
1000000000000000000000100000100000000000000000000001
1000000000000000000001000000010000000000000000000001
1000000000000000000010000000001000000000000000000001
1000000000000000000010000P00001000000000000000000001
1111111111111111111100000000000111111111111111111111
1011000000000000000000000000000000000000000000011001
1000111000000000000000000000000000000000000011100001
1000000110000000000000000000000000000000001100000001
1000000001100000000000000000000000000001110000000001
1000000000011100000000000000000000000110000000000001
1000000000000011000000000000000000011000000000000001
1000000000000010000000000000000000001000000000000001
1000000000000010000000000000000000001000000000000001
100000000000010000E00000000000000C000100000000000001
1000000000000100000000001110000000000100000000000001
1000000000001000000001110001110000000010000000000001
1000000000011000001110000000001110000010000000000001
1000000000010001110000000000000001110001000000000001
1000000000110110000000000000000000001101100000000001
1000000000111000000000000000000000000011100000000001
1111111111111111111111111111111111111111111111111111